1010101010101010101010101010101010
1088404040404040404040404040404010
1040404040404040404040404040A24010
1040404040404040404040404040404010
1040404040404040404040404040404010
1040404040404040404040404040404010
10404040404040404040404040A2404010
10404040E1E1E1E1E1E140404040404010
1040404064646464646440404040404010
1010101010101010101010101010101010